50 
3 22 31 32 40 43 
19 33 14 37 49 42 6 24 
43 16 37 31 8 27 34 11 22 
49 0 47 40 46 32 41 36 14 30 37 
42 25 31 29 41 35 30 
30 31 35 18 16 11 36 20 10 46 19 
44 7 34 1 29 40 18 45 8 
6 31 18 32 21 14 43 46 
6 30 40 2 25 37 31 
41 13 31 32 43 20 46 12 
36 5 38 26 48 42 16 18 29 40 41 37 46 
12 22 45 30 26 5 2 23 
43 37 33 20 11 27 41 9 
39 22 14 41 35 33 9 49 
7 26 32 20 1 3 13 33 
23 44 28 
20 2 33 5 43 26 10 46 
18 42 
7 29 34 19 5 17 31 45 10 6 24 
5 37 24 1 18 41 47 40 
16 39 43 5 44 35 9 14 12 
30 43 44 7 39 49 
13 2 30 11 0 32 38 
27 32 48 37 15 11 
35 29 19 18 1 
8 32 45 4 27 
14 16 11 49 27 32 10 45 
12 41 26 2 49 23 25 
42 15 35 41 43 36 
40 42 36 10 39 48 24 18 30 6 4 
45 29 46 5 3 11 4 21 22 49 8 
0 7 2 8 9 4 18 35 5 
40 25 9 22 0 14 33 23 3 7 39 26 
13 12 14 16 35 32 38 45 44 1 
46 6 2 47 18 
36 5 31 24 33 40 44 37 20 28 38 4 13 
10 28 29 41 38 35 40 5 3 
8 12 35 19 10 23 3 2 1 
44 46 33 22 10 36 43 41 35 
13 29 32 21 44 45 20 
36 0 10 6 44 49 48 32 3 29 8 35 19 
4 12 27 28 3 19 13 10 42 9 36 38 
28 4 10 29 17 41 1 43 
38 12 7 21 42 16 2 9 28 0 47 20 
35 20 47 40 38 21 33 15 39 48 6 
11 26 6 18 39 49 33 25 30 
3 34 7 10 9 30 16 5 38 
44 19 43 34 3 
40 29 23 10 44 
40 27 26 45 21 13 3 30 1 